#########
#GG..####
#G...####
###.C..##
###CC..##
###P.####
#########

