#########
#G..#####
#G#C..###
#GPC..###
#..C.####
###..####
#########

