########
#.G#####
#....###
#*P..###
#..C.###
#..#####
########

