#########
###.G.###
###CG.###
#...G.###
#.CC..###
##.P#####
#########

